QTL_name_new	QTL_name_old (Ting)
eQTL_eQTLGen	eQTL_eQTLGen
eQTL_Microglia_Regulome	eQTL_Microglia_Regulome
eQTL_Adipose	eQTL_Adipose
eQTL_DIRECT	eQTL_DIRECT
eQTL_Fetal_Brain	eQTL_fetal_brain
eQTL_BrainMeta	eQTL_BrainMeta
eQTL_Microglia	eQTL_microglia
eQTL_Brain_Microglia	eQTL_brain_Microglia
eQTL_Brain_Pericytes	eQTL_brain_Pericytes
eQTL_Brain_Oligodendrocytes	eQTL_brain_Oligodendrocytes
eQTL_Brain_Endothelial.cells	eQTL_brain_Endothelial.cells
eQTL_Brain_Inhibitory.neurons	eQTL_brain_Inhibitory.neurons
eQTL_Brain_Excitatory.neurons	eQTL_brain_Excitatory.neurons
eQTL_Brain_OPCs...COPs	eQTL_brain_OPCs...COPs
eQTL_Brain_Astrocytes	eQTL_brain_Astrocytes
eQTL_OneK1K_bin	eQTL_onek1k_bin
eQTL_OneK1K_bmem	eQTL_onek1k_bmem
eQTL_OneK1K_cd4et	eQTL_onek1k_cd4et
eQTL_OneK1K_cd4nc	eQTL_onek1k_cd4nc
eQTL_OneK1K_cd4sox4	eQTL_onek1k_cd4sox4
eQTL_OneK1K_cd8et	eQTL_onek1k_cd8et
eQTL_OneK1K_cd8nc	eQTL_onek1k_cd8nc
eQTL_OneK1K_cd8s100b	eQTL_onek1k_cd8s100b
eQTL_OneK1K_dc	eQTL_onek1k_dc
eQTL_OneK1K_monoc	eQTL_onek1k_monoc
eQTL_OneK1K_mononc	eQTL_onek1k_mononc
eQTL_OneK1K_nk	eQTL_onek1k_nk
eQTL_OneK1K_nkr	eQTL_onek1k_nkr
eQTL_OneK1K_plasma	eQTL_onek1k_plasma
eQTL_GTEx_Adipose_Subcutaneous	eQTL_GTEx_Adipose_Subcutaneous
eQTL_GTEx_Adipose_Visceral_Omentum	eQTL_GTEx_Adipose_Visceral_Omentum
eQTL_GTEx_Adrenal_Gland	eQTL_GTEx_Adrenal_Gland
eQTL_GTEx_Artery_Aorta	eQTL_GTEx_Artery_Aorta
eQTL_GTEx_Artery_Coronary	eQTL_GTEx_Artery_Coronary
eQTL_GTEx_Artery_Tibial	eQTL_GTEx_Artery_Tibial
eQTL_GTEx_Brain_Amygdala	eQTL_GTEx_Brain_Amygdala
eQTL_GTEx_Brain_Anterior_cingulate_cortex_BA24	eQTL_GTEx_Brain_Anterior_cingulate_cortex_BA24
eQTL_GTEx_Brain_Caudate_basal_ganglia	eQTL_GTEx_Brain_Caudate_basal_ganglia
eQTL_GTEx_Brain_Cerebellar_Hemisphere	eQTL_GTEx_Brain_Cerebellar_Hemisphere
eQTL_GTEx_Brain_Cerebellum	eQTL_GTEx_Brain_Cerebellum
eQTL_GTEx_Brain_Cortex	eQTL_GTEx_Brain_Cortex
eQTL_GTEx_Brain_Frontal_Cortex_BA9	eQTL_GTEx_Brain_Frontal_Cortex_BA9
eQTL_GTEx_Brain_Hippocampus	eQTL_GTEx_Brain_Hippocampus
eQTL_GTEx_Brain_Hypothalamus	eQTL_GTEx_Brain_Hypothalamus
eQTL_GTEx_Brain_Nucleus_accumbens_basal_ganglia	eQTL_GTEx_Brain_Nucleus_accumbens_basal_ganglia
eQTL_GTEx_Brain_Putamen_basal_ganglia	eQTL_GTEx_Brain_Putamen_basal_ganglia
eQTL_GTEx_Brain_Spinal_cord_cervical_c-1	eQTL_GTEx_Brain_Spinal_cord_cervical_c-1
eQTL_GTEx_Brain_Substantia_nigra	eQTL_GTEx_Brain_Substantia_nigra
eQTL_GTEx_Breast_Mammary_Tissue	eQTL_GTEx_Breast_Mammary_Tissue
eQTL_GTEx_Cells_Cultured_fibroblasts	eQTL_GTEx_Cells_Cultured_fibroblasts
eQTL_GTEx_Cells_EBV-transformed_lymphocytes	eQTL_GTEx_Cells_EBV-transformed_lymphocytes
eQTL_GTEx_Colon_Sigmoid	eQTL_GTEx_Colon_Sigmoid
eQTL_GTEx_Colon_Transverse	eQTL_GTEx_Colon_Transverse
eQTL_GTEx_Esophagus_Gastroesophageal_Junction	eQTL_GTEx_Esophagus_Gastroesophageal_Junction
eQTL_GTEx_Esophagus_Mucosa	eQTL_GTEx_Esophagus_Mucosa
eQTL_GTEx_Esophagus_Muscularis	eQTL_GTEx_Esophagus_Muscularis
eQTL_GTEx_Heart_Atrial_Appendage	eQTL_GTEx_Heart_Atrial_Appendage
eQTL_GTEx_Heart_Left_Ventricle	eQTL_GTEx_Heart_Left_Ventricle
eQTL_GTEx_Kidney_Cortex	eQTL_GTEx_Kidney_Cortex
eQTL_GTEx_Liver	eQTL_GTEx_Liver
eQTL_GTEx_Lung	eQTL_GTEx_Lung
eQTL_GTEx_Minor_Salivary_Gland	eQTL_GTEx_Minor_Salivary_Gland
eQTL_GTEx_Muscle_Skeletal	eQTL_GTEx_Muscle_Skeletal
eQTL_GTEx_Nerve_Tibial	eQTL_GTEx_Nerve_Tibial
eQTL_GTEx_Ovary	eQTL_GTEx_Ovary
eQTL_GTEx_Pancreas	eQTL_GTEx_Pancreas
eQTL_GTEx_Pituitary	eQTL_GTEx_Pituitary
eQTL_GTEx_Prostate	eQTL_GTEx_Prostate
eQTL_GTEx_Skin_Not_Sun_Exposed_Suprapubic	eQTL_GTEx_Skin_Not_Sun_Exposed_Suprapubic
eQTL_GTEx_Skin_Sun_Exposed_Lower_leg	eQTL_GTEx_Skin_Sun_Exposed_Lower_leg
eQTL_GTEx_Small_Intestine_Terminal_Ileum	eQTL_GTEx_Small_Intestine_Terminal_Ileum
eQTL_GTEx_Spleen	eQTL_GTEx_Spleen
eQTL_GTEx_Stomach	eQTL_GTEx_Stomach
eQTL_GTEx_Testis	eQTL_GTEx_Testis
eQTL_GTEx_Thyroid	eQTL_GTEx_Thyroid
eQTL_GTEx_Uterus	eQTL_GTEx_Uterus
eQTL_GTEx_Vagina	eQTL_GTEx_Vagina
eQTL_GTEx_Whole_Blood	eQTL_GTEx_Whole_Blood
eQTL_ROSMAP_snRNA_celltype_Ast	ROSMAP_snRNA_celltype_Ast
eQTL_ROSMAP_snRNA_celltype_End	ROSMAP_snRNA_celltype_End
eQTL_ROSMAP_snRNA_celltype_Exc	ROSMAP_snRNA_celltype_Exc
eQTL_ROSMAP_snRNA_celltype_Inh	ROSMAP_snRNA_celltype_Inh
eQTL_ROSMAP_snRNA_celltype_Mic	ROSMAP_snRNA_celltype_Mic
eQTL_ROSMAP_snRNA_celltype_Oli	ROSMAP_snRNA_celltype_Oli
eQTL_ROSMAP_snRNA_celltype_OPC	ROSMAP_snRNA_celltype_OPC
eQTL_ROSMAP_snRNA_subtype_Ast.10	ROSMAP_snRNA_subtype_Ast.10
eQTL_ROSMAP_snRNA_subtype_Ast.1	ROSMAP_snRNA_subtype_Ast.1
eQTL_ROSMAP_snRNA_subtype_Ast.2	ROSMAP_snRNA_subtype_Ast.2
eQTL_ROSMAP_snRNA_subtype_Ast.3	ROSMAP_snRNA_subtype_Ast.3
eQTL_ROSMAP_snRNA_subtype_Ast.4	ROSMAP_snRNA_subtype_Ast.4
eQTL_ROSMAP_snRNA_subtype_Ast.5	ROSMAP_snRNA_subtype_Ast.5
eQTL_ROSMAP_snRNA_subtype_Ast.6	ROSMAP_snRNA_subtype_Ast.6
eQTL_ROSMAP_snRNA_subtype_End.2	ROSMAP_snRNA_subtype_End.2
eQTL_ROSMAP_snRNA_subtype_Exc.10	ROSMAP_snRNA_subtype_Exc.10
eQTL_ROSMAP_snRNA_subtype_Exc.11	ROSMAP_snRNA_subtype_Exc.11
eQTL_ROSMAP_snRNA_subtype_Exc.12	ROSMAP_snRNA_subtype_Exc.12
eQTL_ROSMAP_snRNA_subtype_Exc.13	ROSMAP_snRNA_subtype_Exc.13
eQTL_ROSMAP_snRNA_subtype_Exc.14	ROSMAP_snRNA_subtype_Exc.14
eQTL_ROSMAP_snRNA_subtype_Exc.15	ROSMAP_snRNA_subtype_Exc.15
eQTL_ROSMAP_snRNA_subtype_Exc.16	ROSMAP_snRNA_subtype_Exc.16
eQTL_ROSMAP_snRNA_subtype_Exc.1	ROSMAP_snRNA_subtype_Exc.1
eQTL_ROSMAP_snRNA_subtype_Exc.2	ROSMAP_snRNA_subtype_Exc.2
eQTL_ROSMAP_snRNA_subtype_Exc.3	ROSMAP_snRNA_subtype_Exc.3
eQTL_ROSMAP_snRNA_subtype_Exc.4	ROSMAP_snRNA_subtype_Exc.4
eQTL_ROSMAP_snRNA_subtype_Exc.5	ROSMAP_snRNA_subtype_Exc.5
eQTL_ROSMAP_snRNA_subtype_Exc.6	ROSMAP_snRNA_subtype_Exc.6
eQTL_ROSMAP_snRNA_subtype_Exc.7	ROSMAP_snRNA_subtype_Exc.7
eQTL_ROSMAP_snRNA_subtype_Exc.8	ROSMAP_snRNA_subtype_Exc.8
eQTL_ROSMAP_snRNA_subtype_Exc.9	ROSMAP_snRNA_subtype_Exc.9
eQTL_ROSMAP_snRNA_subtype_Fib.3	ROSMAP_snRNA_subtype_Fib.3
eQTL_ROSMAP_snRNA_subtype_Inh.10	ROSMAP_snRNA_subtype_Inh.10
eQTL_ROSMAP_snRNA_subtype_Inh.11	ROSMAP_snRNA_subtype_Inh.11
eQTL_ROSMAP_snRNA_subtype_Inh.12	ROSMAP_snRNA_subtype_Inh.12
eQTL_ROSMAP_snRNA_subtype_Inh.13	ROSMAP_snRNA_subtype_Inh.13
eQTL_ROSMAP_snRNA_subtype_Inh.15	ROSMAP_snRNA_subtype_Inh.15
eQTL_ROSMAP_snRNA_subtype_Inh.16	ROSMAP_snRNA_subtype_Inh.16
eQTL_ROSMAP_snRNA_subtype_Inh.2	ROSMAP_snRNA_subtype_Inh.2
eQTL_ROSMAP_snRNA_subtype_Inh.3	ROSMAP_snRNA_subtype_Inh.3
eQTL_ROSMAP_snRNA_subtype_Inh.4	ROSMAP_snRNA_subtype_Inh.4
eQTL_ROSMAP_snRNA_subtype_Inh.5	ROSMAP_snRNA_subtype_Inh.5
eQTL_ROSMAP_snRNA_subtype_Inh.6	ROSMAP_snRNA_subtype_Inh.6
eQTL_ROSMAP_snRNA_subtype_Inh.7	ROSMAP_snRNA_subtype_Inh.7
eQTL_ROSMAP_snRNA_subtype_Inh.8	ROSMAP_snRNA_subtype_Inh.8
eQTL_ROSMAP_snRNA_subtype_Inh.9	ROSMAP_snRNA_subtype_Inh.9
eQTL_ROSMAP_snRNA_subtype_Mac	ROSMAP_snRNA_subtype_Mac
eQTL_ROSMAP_snRNA_subtype_Mic.10	ROSMAP_snRNA_subtype_Mic.10
eQTL_ROSMAP_snRNA_subtype_Mic.12	ROSMAP_snRNA_subtype_Mic.12
eQTL_ROSMAP_snRNA_subtype_Mic.13	ROSMAP_snRNA_subtype_Mic.13
eQTL_ROSMAP_snRNA_subtype_Mic.2	ROSMAP_snRNA_subtype_Mic.2
eQTL_ROSMAP_snRNA_subtype_Mic.3	ROSMAP_snRNA_subtype_Mic.3
eQTL_ROSMAP_snRNA_subtype_Mic.4	ROSMAP_snRNA_subtype_Mic.4
eQTL_ROSMAP_snRNA_subtype_Mic.5	ROSMAP_snRNA_subtype_Mic.5
eQTL_ROSMAP_snRNA_subtype_Mic.6	ROSMAP_snRNA_subtype_Mic.6
eQTL_ROSMAP_snRNA_subtype_Mic.7	ROSMAP_snRNA_subtype_Mic.7
eQTL_ROSMAP_snRNA_subtype_Mic.8	ROSMAP_snRNA_subtype_Mic.8
eQTL_ROSMAP_snRNA_subtype_Mic.9	ROSMAP_snRNA_subtype_Mic.9
eQTL_ROSMAP_snRNA_subtype_Oli.11	ROSMAP_snRNA_subtype_Oli.11
eQTL_ROSMAP_snRNA_subtype_Oli.1	ROSMAP_snRNA_subtype_Oli.1
eQTL_ROSMAP_snRNA_subtype_Oli.2	ROSMAP_snRNA_subtype_Oli.2
eQTL_ROSMAP_snRNA_subtype_Oli.3	ROSMAP_snRNA_subtype_Oli.3
eQTL_ROSMAP_snRNA_subtype_Oli.4	ROSMAP_snRNA_subtype_Oli.4
eQTL_ROSMAP_snRNA_subtype_Oli.5	ROSMAP_snRNA_subtype_Oli.5
eQTL_ROSMAP_snRNA_subtype_Oli.6	ROSMAP_snRNA_subtype_Oli.6
eQTL_ROSMAP_snRNA_subtype_Oli.7	ROSMAP_snRNA_subtype_Oli.7
eQTL_ROSMAP_snRNA_subtype_Oli.9	ROSMAP_snRNA_subtype_Oli.9
eQTL_ROSMAP_snRNA_subtype_OPC.1	ROSMAP_snRNA_subtype_OPC.1
eQTL_ROSMAP_snRNA_subtype_OPC.2	ROSMAP_snRNA_subtype_OPC.2
eQTL_ROSMAP_snRNA_subtype_OPC.3	ROSMAP_snRNA_subtype_OPC.3
eQTL_ROSMAP_snRNA_subtype_Peri.2	ROSMAP_snRNA_subtype_Peri.2
sQTL_Microglia	sQTL_microglia
sQTL_BrainMeta	sQTL_BrainMeta
sQTL_GTEx_Adipose_Subcutaneous	sQTL_GTEx_Adipose_Subcutaneous
sQTL_GTEx_Adipose_Visceral_Omentum	sQTL_GTEx_Adipose_Visceral_Omentum
sQTL_GTEx_Adrenal_Gland	sQTL_GTEx_Adrenal_Gland
sQTL_GTEx_Artery_Aorta	sQTL_GTEx_Artery_Aorta
sQTL_GTEx_Artery_Coronary	sQTL_GTEx_Artery_Coronary
sQTL_GTEx_Artery_Tibial	sQTL_GTEx_Artery_Tibial
sQTL_GTEx_Brain_Amygdala	sQTL_GTEx_Brain_Amygdala
sQTL_GTEx_Brain_Anterior_cingulate_cortex_BA24	sQTL_GTEx_Brain_Anterior_cingulate_cortex_BA24
sQTL_GTEx_Brain_Caudate_basal_ganglia	sQTL_GTEx_Brain_Caudate_basal_ganglia
sQTL_GTEx_Brain_Cerebellar_Hemisphere	sQTL_GTEx_Brain_Cerebellar_Hemisphere
sQTL_GTEx_Brain_Cerebellum	sQTL_GTEx_Brain_Cerebellum
sQTL_GTEx_Brain_Cortex	sQTL_GTEx_Brain_Cortex
sQTL_GTEx_Brain_Frontal_Cortex_BA9	sQTL_GTEx_Brain_Frontal_Cortex_BA9
sQTL_GTEx_Brain_Hippocampus	sQTL_GTEx_Brain_Hippocampus
sQTL_GTEx_Brain_Hypothalamus	sQTL_GTEx_Brain_Hypothalamus
sQTL_GTEx_Brain_Nucleus_accumbens_basal_ganglia	sQTL_GTEx_Brain_Nucleus_accumbens_basal_ganglia
sQTL_GTEx_Brain_Putamen_basal_ganglia	sQTL_GTEx_Brain_Putamen_basal_ganglia
sQTL_GTEx_Brain_Spinal_cord_cervical_c-1	sQTL_GTEx_Brain_Spinal_cord_cervical_c-1
sQTL_GTEx_Brain_Substantia_nigra	sQTL_GTEx_Brain_Substantia_nigra
sQTL_GTEx_Breast_Mammary_Tissue	sQTL_GTEx_Breast_Mammary_Tissue
sQTL_GTEx_Cells_Cultured_fibroblasts	sQTL_GTEx_Cells_Cultured_fibroblasts
sQTL_GTEx_Cells_EBV-transformed_lymphocytes	sQTL_GTEx_Cells_EBV-transformed_lymphocytes
sQTL_GTEx_Colon_Sigmoid	sQTL_GTEx_Colon_Sigmoid
sQTL_GTEx_Colon_Transverse	sQTL_GTEx_Colon_Transverse
sQTL_GTEx_Esophagus_Gastroesophageal_Junction	sQTL_GTEx_Esophagus_Gastroesophageal_Junction
sQTL_GTEx_Esophagus_Mucosa	sQTL_GTEx_Esophagus_Mucosa
sQTL_GTEx_Esophagus_Muscularis	sQTL_GTEx_Esophagus_Muscularis
sQTL_GTEx_Heart_Atrial_Appendage	sQTL_GTEx_Heart_Atrial_Appendage
sQTL_GTEx_Heart_Left_Ventricle	sQTL_GTEx_Heart_Left_Ventricle
sQTL_GTEx_Kidney_Cortex	sQTL_GTEx_Kidney_Cortex
sQTL_GTEx_Liver	sQTL_GTEx_Liver
sQTL_GTEx_Lung	sQTL_GTEx_Lung
sQTL_GTEx_Minor_Salivary_Gland	sQTL_GTEx_Minor_Salivary_Gland
sQTL_GTEx_Muscle_Skeletal	sQTL_GTEx_Muscle_Skeletal
sQTL_GTEx_Nerve_Tibial	sQTL_GTEx_Nerve_Tibial
sQTL_GTEx_Ovary	sQTL_GTEx_Ovary
sQTL_GTEx_Pancreas	sQTL_GTEx_Pancreas
sQTL_GTEx_Pituitary	sQTL_GTEx_Pituitary
sQTL_GTEx_Prostate	sQTL_GTEx_Prostate
sQTL_GTEx_Skin_Not_Sun_Exposed_Suprapubic	sQTL_GTEx_Skin_Not_Sun_Exposed_Suprapubic
sQTL_GTEx_Skin_Sun_Exposed_Lower_leg	sQTL_GTEx_Skin_Sun_Exposed_Lower_leg
sQTL_GTEx_Small_Intestine_Terminal_Ileum	sQTL_GTEx_Small_Intestine_Terminal_Ileum
sQTL_GTEx_Spleen	sQTL_GTEx_Spleen
sQTL_GTEx_Stomach	sQTL_GTEx_Stomach
sQTL_GTEx_Testis	sQTL_GTEx_Testis
sQTL_GTEx_Thyroid	sQTL_GTEx_Thyroid
sQTL_GTEx_Uterus	sQTL_GTEx_Uterus
sQTL_GTEx_Vagina	sQTL_GTEx_Vagina
sQTL_GTEx_Whole_Blood	sQTL_GTEx_Whole_Blood
pQTL_3brain	pQTL_3brain
pQTL_6plasma	pQTL_6plasma
pQTL_FHS	pQTL_FHS
pQTL_FENLAND	pQTL_FENLAND
pQTL_ARIC	pQTL_ARIC
pQTL_UKB_Phase2	pQTL_UKB_Phase2
pQTL_AGES	pQTL_AGES
mQTL_GoDMC	GoDMC
mQTL_BrainMeta	BrainmMeta
mQTL_GTEx_Breast_Mammary_Tissue	mQTL_GTEx_BreastMammaryTissue
mQTL_GTEx_Kidney_Cortex	mQTL_GTEx_KidneyCortex
mQTL_GTEx_Muscle_Skeletal	mQTL_GTEx_MuscleSkeletal
mQTL_GTEx_Prostate	mQTL_GTEx_Prostate
mQTL_GTEx_Whole_Blood	mQTL_GTEx_WholeBlood
mQTL_GTEx_Colon_Transverse	mQTL_GTEx_ColonTransverse
mQTL_GTEx_Lung	mQTL_GTEx_Lung
mQTL_GTEx_Ovary	mQTL_GTEx_Ovary
mQTL_GTEx_Testis	mQTL_GTEx_Testis
hQTL_H3K9ac_ROSMAP	H3K9ac_ROSMAP
hQTL_H3K4me1_BLUEPRINT	H3K4me1_BLUEPRINT
hQTL_H3K27ac_BLUEPRINT	H3K27ac_BLUEPRINT
hQTL_H3K27ac_GTEx_Heart	H3K27ac_GTEx_heart
hQTL_H3K27ac_GTEx_Brain	H3K27ac_GTEx_brain
hQTL_H3K27ac_GTEx_Lung	H3K27ac_GTEx_lung
hQTL_H3K27ac_GTEx_Muscle	H3K27ac_GTEx_muscle
caQTL_Brain	caQTL_brain
caQTL_Blood	caQTL_blood
caQTL_Neuro	caQTL_neuro
caQTL_Glia	caQTL_glia
caQTL_Microglia	caQTL_Microglia
