eQTLGen	/storage/yangjianLab/sharedata/molecular_QTL/eQTL/eQTLGen/cis-eQTL/GRCh38/eQTLGen_CHRALL	FALSE
eQTL_Microglia_Regulome	/storage/yangjianLab/sharedata/molecular_QTL/eQTL/Microglia_Regulome_Kosoy_2022_NG/besd/Microglia_meta_eQTL_chr	TRUE
eQTL_Adipose	/storage/yangjianLab/sharedata/molecular_QTL/eQTL/Adipose_eQTL/BESD/GRCh38/geneQTL_METSIM_n426_adipose_summaryStats_1Mb_chr	TRUE
eQTL_DIRECT	/storage/yangjianLab/sharedata/molecular_QTL/eQTL/DIRECT/besd/GRCh38/DIRECT_CHRALL	FALSE
eQTL_Fetal_Brain	/storage/yangjianLab/sharedata/molecular_QTL/eQTL/fetal_brain/Brien_2018_Fetal_Brain_eQTL_GRCh38	FALSE
eQTL_BrainMeta	/storage/yangjianLab/sharedata/molecular_QTL/eQTL/BrainMeta_cis_eqtl_summary/GRCh38/BrainMeta_cis_eQTL_chr	TRUE
eQTL_Microglia	/storage/yangjianLab/sharedata/molecular_QTL/eQTL/microglia_QTL/microglia_meta_eQTL_and_sQTL/GRCh38_version/SMR_besd_format/out_miga_young_mynd_fairfax.metasoft_besd_format	FALSE
eQTL_Brain_Microglia	/storage/yangjianLab/sharedata/molecular_QTL/eQTL/eight_brain_cell_type_eQTL/brain_cell_type_cis_QTL/SMR_besd_format/GRCh38/Microglia_besd_format	FALSE
eQTL_Brain_Pericytes	/storage/yangjianLab/sharedata/molecular_QTL/eQTL/eight_brain_cell_type_eQTL/brain_cell_type_cis_QTL/SMR_besd_format/GRCh38/Pericytes_besd_format	FALSE
eQTL_Brain_Oligodendrocytes	/storage/yangjianLab/sharedata/molecular_QTL/eQTL/eight_brain_cell_type_eQTL/brain_cell_type_cis_QTL/SMR_besd_format/GRCh38/Oligodendrocytes_besd_format	FALSE
eQTL_Brain_Endothelial.cells	/storage/yangjianLab/sharedata/molecular_QTL/eQTL/eight_brain_cell_type_eQTL/brain_cell_type_cis_QTL/SMR_besd_format/GRCh38/Endothelial.cells_besd_format	FALSE
eQTL_Brain_Inhibitory.neurons	/storage/yangjianLab/sharedata/molecular_QTL/eQTL/eight_brain_cell_type_eQTL/brain_cell_type_cis_QTL/SMR_besd_format/GRCh38/Inhibitory.neurons_besd_format	FALSE
eQTL_Brain_Excitatory.neurons	/storage/yangjianLab/sharedata/molecular_QTL/eQTL/eight_brain_cell_type_eQTL/brain_cell_type_cis_QTL/SMR_besd_format/GRCh38/Excitatory.neurons_besd_format	FALSE
eQTL_Brain_OPCs...COPs	/storage/yangjianLab/sharedata/molecular_QTL/eQTL/eight_brain_cell_type_eQTL/brain_cell_type_cis_QTL/SMR_besd_format/GRCh38/OPCs...COPs_besd_format	FALSE
eQTL_Brain_Astrocytes	/storage/yangjianLab/sharedata/molecular_QTL/eQTL/eight_brain_cell_type_eQTL/brain_cell_type_cis_QTL/SMR_besd_format/GRCh38/Astrocytes_besd_format	FALSE
eQTL_OneK1K_bin	/storage/yangjianLab/sharedata/molecular_QTL/eQTL/OneK1K/besd/bin_onek1k_eqtl	FALSE
eQTL_OneK1K_bmem	/storage/yangjianLab/sharedata/molecular_QTL/eQTL/OneK1K/besd/bmem_onek1k_eqtl	FALSE
eQTL_OneK1K_cd4et	/storage/yangjianLab/sharedata/molecular_QTL/eQTL/OneK1K/besd/cd4et_onek1k_eqtl	FALSE
eQTL_OneK1K_cd4nc	/storage/yangjianLab/sharedata/molecular_QTL/eQTL/OneK1K/besd/cd4nc_onek1k_eqtl	FALSE
eQTL_OneK1K_cd4sox4	/storage/yangjianLab/sharedata/molecular_QTL/eQTL/OneK1K/besd/cd4sox4_onek1k_eqtl	FALSE
eQTL_OneK1K_cd8et	/storage/yangjianLab/sharedata/molecular_QTL/eQTL/OneK1K/besd/cd8et_onek1k_eqtl	FALSE
eQTL_OneK1K_cd8nc	/storage/yangjianLab/sharedata/molecular_QTL/eQTL/OneK1K/besd/cd8nc_onek1k_eqtl	FALSE
eQTL_OneK1K_cd8s100b	/storage/yangjianLab/sharedata/molecular_QTL/eQTL/OneK1K/besd/cd8s100b_onek1k_eqtl	FALSE
eQTL_OneK1K_dc	/storage/yangjianLab/sharedata/molecular_QTL/eQTL/OneK1K/besd/dc_onek1k_eqtl	FALSE
eQTL_OneK1K_monoc	/storage/yangjianLab/sharedata/molecular_QTL/eQTL/OneK1K/besd/monoc_onek1k_eqtl	FALSE
eQTL_OneK1K_mononc	/storage/yangjianLab/sharedata/molecular_QTL/eQTL/OneK1K/besd/mononc_onek1k_eqtl	FALSE
eQTL_OneK1K_nk	/storage/yangjianLab/sharedata/molecular_QTL/eQTL/OneK1K/besd/nk_onek1k_eqtl	FALSE
eQTL_OneK1K_nkr	/storage/yangjianLab/sharedata/molecular_QTL/eQTL/OneK1K/besd/nkr_onek1k_eqtl	FALSE
eQTL_OneK1K_plasma	/storage/yangjianLab/sharedata/molecular_QTL/eQTL/OneK1K/besd/plasma_onek1k_eqtl	FALSE
eQTL_GTEx_Adipose_Subcutaneous	/storage/yangjianLab/sharedata/molecular_QTL/eQTL/gtex_resources_besd/eQTL_hg38/eQTL_besd_hg38/Adipose_Subcutaneous_eQTL_all_chr	TRUE
eQTL_GTEx_Adipose_Visceral_Omentum	/storage/yangjianLab/sharedata/molecular_QTL/eQTL/gtex_resources_besd/eQTL_hg38/eQTL_besd_hg38/Adipose_Visceral_Omentum_eQTL_all_chr	TRUE
eQTL_GTEx_Adrenal_Gland	/storage/yangjianLab/sharedata/molecular_QTL/eQTL/gtex_resources_besd/eQTL_hg38/eQTL_besd_hg38/Adrenal_Gland_eQTL_all_chr	TRUE
eQTL_GTEx_Artery_Aorta	/storage/yangjianLab/sharedata/molecular_QTL/eQTL/gtex_resources_besd/eQTL_hg38/eQTL_besd_hg38/Artery_Aorta_eQTL_all_chr	TRUE
eQTL_GTEx_Artery_Coronary	/storage/yangjianLab/sharedata/molecular_QTL/eQTL/gtex_resources_besd/eQTL_hg38/eQTL_besd_hg38/Artery_Coronary_eQTL_all_chr	TRUE
eQTL_GTEx_Artery_Tibial	/storage/yangjianLab/sharedata/molecular_QTL/eQTL/gtex_resources_besd/eQTL_hg38/eQTL_besd_hg38/Artery_Tibial_eQTL_all_chr	TRUE
eQTL_GTEx_Brain_Amygdala	/storage/yangjianLab/sharedata/molecular_QTL/eQTL/gtex_resources_besd/eQTL_hg38/eQTL_besd_hg38/Brain_Amygdala_eQTL_all_chr	TRUE
eQTL_GTEx_Brain_Anterior_cingulate_cortex_BA24	/storage/yangjianLab/sharedata/molecular_QTL/eQTL/gtex_resources_besd/eQTL_hg38/eQTL_besd_hg38/Brain_Anterior_cingulate_cortex_BA24_eQTL_all_chr	TRUE
eQTL_GTEx_Brain_Caudate_basal_ganglia	/storage/yangjianLab/sharedata/molecular_QTL/eQTL/gtex_resources_besd/eQTL_hg38/eQTL_besd_hg38/Brain_Caudate_basal_ganglia_eQTL_all_chr	TRUE
eQTL_GTEx_Brain_Cerebellar_Hemisphere	/storage/yangjianLab/sharedata/molecular_QTL/eQTL/gtex_resources_besd/eQTL_hg38/eQTL_besd_hg38/Brain_Cerebellar_Hemisphere_eQTL_all_chr	TRUE
eQTL_GTEx_Brain_Cerebellum	/storage/yangjianLab/sharedata/molecular_QTL/eQTL/gtex_resources_besd/eQTL_hg38/eQTL_besd_hg38/Brain_Cerebellum_eQTL_all_chr	TRUE
eQTL_GTEx_Brain_Cortex	/storage/yangjianLab/sharedata/molecular_QTL/eQTL/gtex_resources_besd/eQTL_hg38/eQTL_besd_hg38/Brain_Cortex_eQTL_all_chr	TRUE
eQTL_GTEx_Brain_Frontal_Cortex_BA9	/storage/yangjianLab/sharedata/molecular_QTL/eQTL/gtex_resources_besd/eQTL_hg38/eQTL_besd_hg38/Brain_Frontal_Cortex_BA9_eQTL_all_chr	TRUE
eQTL_GTEx_Brain_Hippocampus	/storage/yangjianLab/sharedata/molecular_QTL/eQTL/gtex_resources_besd/eQTL_hg38/eQTL_besd_hg38/Brain_Hippocampus_eQTL_all_chr	TRUE
eQTL_GTEx_Brain_Hypothalamus	/storage/yangjianLab/sharedata/molecular_QTL/eQTL/gtex_resources_besd/eQTL_hg38/eQTL_besd_hg38/Brain_Hypothalamus_eQTL_all_chr	TRUE
eQTL_GTEx_Brain_Nucleus_accumbens_basal_ganglia	/storage/yangjianLab/sharedata/molecular_QTL/eQTL/gtex_resources_besd/eQTL_hg38/eQTL_besd_hg38/Brain_Nucleus_accumbens_basal_ganglia_eQTL_all_chr	TRUE
eQTL_GTEx_Brain_Putamen_basal_ganglia	/storage/yangjianLab/sharedata/molecular_QTL/eQTL/gtex_resources_besd/eQTL_hg38/eQTL_besd_hg38/Brain_Putamen_basal_ganglia_eQTL_all_chr	TRUE
eQTL_GTEx_Brain_Spinal_cord_cervical_c-1	/storage/yangjianLab/sharedata/molecular_QTL/eQTL/gtex_resources_besd/eQTL_hg38/eQTL_besd_hg38/Brain_Spinal_cord_cervical_c-1_eQTL_all_chr	TRUE
eQTL_GTEx_Brain_Substantia_nigra	/storage/yangjianLab/sharedata/molecular_QTL/eQTL/gtex_resources_besd/eQTL_hg38/eQTL_besd_hg38/Brain_Substantia_nigra_eQTL_all_chr	TRUE
eQTL_GTEx_Breast_Mammary_Tissue	/storage/yangjianLab/sharedata/molecular_QTL/eQTL/gtex_resources_besd/eQTL_hg38/eQTL_besd_hg38/Breast_Mammary_Tissue_eQTL_all_chr	TRUE
eQTL_GTEx_Cells_Cultured_fibroblasts	/storage/yangjianLab/sharedata/molecular_QTL/eQTL/gtex_resources_besd/eQTL_hg38/eQTL_besd_hg38/Cells_Cultured_fibroblasts_eQTL_all_chr	TRUE
eQTL_GTEx_Cells_EBV-transformed_lymphocytes	/storage/yangjianLab/sharedata/molecular_QTL/eQTL/gtex_resources_besd/eQTL_hg38/eQTL_besd_hg38/Cells_EBV-transformed_lymphocytes_eQTL_all_chr	TRUE
eQTL_GTEx_Colon_Sigmoid	/storage/yangjianLab/sharedata/molecular_QTL/eQTL/gtex_resources_besd/eQTL_hg38/eQTL_besd_hg38/Colon_Sigmoid_eQTL_all_chr	TRUE
eQTL_GTEx_Colon_Transverse	/storage/yangjianLab/sharedata/molecular_QTL/eQTL/gtex_resources_besd/eQTL_hg38/eQTL_besd_hg38/Colon_Transverse_eQTL_all_chr	TRUE
eQTL_GTEx_Esophagus_Gastroesophageal_Junction	/storage/yangjianLab/sharedata/molecular_QTL/eQTL/gtex_resources_besd/eQTL_hg38/eQTL_besd_hg38/Esophagus_Gastroesophageal_Junction_eQTL_all_chr	TRUE
eQTL_GTEx_Esophagus_Mucosa	/storage/yangjianLab/sharedata/molecular_QTL/eQTL/gtex_resources_besd/eQTL_hg38/eQTL_besd_hg38/Esophagus_Mucosa_eQTL_all_chr	TRUE
eQTL_GTEx_Esophagus_Muscularis	/storage/yangjianLab/sharedata/molecular_QTL/eQTL/gtex_resources_besd/eQTL_hg38/eQTL_besd_hg38/Esophagus_Muscularis_eQTL_all_chr	TRUE
eQTL_GTEx_Heart_Atrial_Appendage	/storage/yangjianLab/sharedata/molecular_QTL/eQTL/gtex_resources_besd/eQTL_hg38/eQTL_besd_hg38/Heart_Atrial_Appendage_eQTL_all_chr	TRUE
eQTL_GTEx_Heart_Left_Ventricle	/storage/yangjianLab/sharedata/molecular_QTL/eQTL/gtex_resources_besd/eQTL_hg38/eQTL_besd_hg38/Heart_Left_Ventricle_eQTL_all_chr	TRUE
eQTL_GTEx_Kidney_Cortex	/storage/yangjianLab/sharedata/molecular_QTL/eQTL/gtex_resources_besd/eQTL_hg38/eQTL_besd_hg38/Kidney_Cortex_eQTL_all_chr	TRUE
eQTL_GTEx_Liver	/storage/yangjianLab/sharedata/molecular_QTL/eQTL/gtex_resources_besd/eQTL_hg38/eQTL_besd_hg38/Liver_eQTL_all_chr	TRUE
eQTL_GTEx_Lung	/storage/yangjianLab/sharedata/molecular_QTL/eQTL/gtex_resources_besd/eQTL_hg38/eQTL_besd_hg38/Lung_eQTL_all_chr	TRUE
eQTL_GTEx_Minor_Salivary_Gland	/storage/yangjianLab/sharedata/molecular_QTL/eQTL/gtex_resources_besd/eQTL_hg38/eQTL_besd_hg38/Minor_Salivary_Gland_eQTL_all_chr	TRUE
eQTL_GTEx_Muscle_Skeletal	/storage/yangjianLab/sharedata/molecular_QTL/eQTL/gtex_resources_besd/eQTL_hg38/eQTL_besd_hg38/Muscle_Skeletal_eQTL_all_chr	TRUE
eQTL_GTEx_Nerve_Tibial	/storage/yangjianLab/sharedata/molecular_QTL/eQTL/gtex_resources_besd/eQTL_hg38/eQTL_besd_hg38/Nerve_Tibial_eQTL_all_chr	TRUE
eQTL_GTEx_Ovary	/storage/yangjianLab/sharedata/molecular_QTL/eQTL/gtex_resources_besd/eQTL_hg38/eQTL_besd_hg38/Ovary_eQTL_all_chr	TRUE
eQTL_GTEx_Pancreas	/storage/yangjianLab/sharedata/molecular_QTL/eQTL/gtex_resources_besd/eQTL_hg38/eQTL_besd_hg38/Pancreas_eQTL_all_chr	TRUE
eQTL_GTEx_Pituitary	/storage/yangjianLab/sharedata/molecular_QTL/eQTL/gtex_resources_besd/eQTL_hg38/eQTL_besd_hg38/Pituitary_eQTL_all_chr	TRUE
eQTL_GTEx_Prostate	/storage/yangjianLab/sharedata/molecular_QTL/eQTL/gtex_resources_besd/eQTL_hg38/eQTL_besd_hg38/Prostate_eQTL_all_chr	TRUE
eQTL_GTEx_Skin_Not_Sun_Exposed_Suprapubic	/storage/yangjianLab/sharedata/molecular_QTL/eQTL/gtex_resources_besd/eQTL_hg38/eQTL_besd_hg38/Skin_Not_Sun_Exposed_Suprapubic_eQTL_all_chr	TRUE
eQTL_GTEx_Skin_Sun_Exposed_Lower_leg	/storage/yangjianLab/sharedata/molecular_QTL/eQTL/gtex_resources_besd/eQTL_hg38/eQTL_besd_hg38/Skin_Sun_Exposed_Lower_leg_eQTL_all_chr	TRUE
eQTL_GTEx_Small_Intestine_Terminal_Ileum	/storage/yangjianLab/sharedata/molecular_QTL/eQTL/gtex_resources_besd/eQTL_hg38/eQTL_besd_hg38/Small_Intestine_Terminal_Ileum_eQTL_all_chr	TRUE
eQTL_GTEx_Spleen	/storage/yangjianLab/sharedata/molecular_QTL/eQTL/gtex_resources_besd/eQTL_hg38/eQTL_besd_hg38/Spleen_eQTL_all_chr	TRUE
eQTL_GTEx_Stomach	/storage/yangjianLab/sharedata/molecular_QTL/eQTL/gtex_resources_besd/eQTL_hg38/eQTL_besd_hg38/Stomach_eQTL_all_chr	TRUE
eQTL_GTEx_Testis	/storage/yangjianLab/sharedata/molecular_QTL/eQTL/gtex_resources_besd/eQTL_hg38/eQTL_besd_hg38/Testis_eQTL_all_chr	TRUE
eQTL_GTEx_Thyroid	/storage/yangjianLab/sharedata/molecular_QTL/eQTL/gtex_resources_besd/eQTL_hg38/eQTL_besd_hg38/Thyroid_eQTL_all_chr	TRUE
eQTL_GTEx_Uterus	/storage/yangjianLab/sharedata/molecular_QTL/eQTL/gtex_resources_besd/eQTL_hg38/eQTL_besd_hg38/Uterus_eQTL_all_chr	TRUE
eQTL_GTEx_Vagina	/storage/yangjianLab/sharedata/molecular_QTL/eQTL/gtex_resources_besd/eQTL_hg38/eQTL_besd_hg38/Vagina_eQTL_all_chr	TRUE
eQTL_GTEx_Whole_Blood	/storage/yangjianLab/sharedata/molecular_QTL/eQTL/gtex_resources_besd/eQTL_hg38/eQTL_besd_hg38/Whole_Blood_eQTL_all_chr	TRUE
eQTL_ROSMAP_snRNA_celltype_Ast	/storage/yangjianLab/sharedata/molecular_QTL/eQTL/ROSMAP_snRNAseq_Fujita_2024NG/besd/celltype/celltype-eqtl-sumstats.Ast	FALSE
eQTL_ROSMAP_snRNA_celltype_End	/storage/yangjianLab/sharedata/molecular_QTL/eQTL/ROSMAP_snRNAseq_Fujita_2024NG/besd/celltype/celltype-eqtl-sumstats.End	FALSE
eQTL_ROSMAP_snRNA_celltype_Exc	/storage/yangjianLab/sharedata/molecular_QTL/eQTL/ROSMAP_snRNAseq_Fujita_2024NG/besd/celltype/celltype-eqtl-sumstats.Exc	FALSE
eQTL_ROSMAP_snRNA_celltype_Inh	/storage/yangjianLab/sharedata/molecular_QTL/eQTL/ROSMAP_snRNAseq_Fujita_2024NG/besd/celltype/celltype-eqtl-sumstats.Inh	FALSE
eQTL_ROSMAP_snRNA_celltype_Mic	/storage/yangjianLab/sharedata/molecular_QTL/eQTL/ROSMAP_snRNAseq_Fujita_2024NG/besd/celltype/celltype-eqtl-sumstats.Mic	FALSE
eQTL_ROSMAP_snRNA_celltype_Oli	/storage/yangjianLab/sharedata/molecular_QTL/eQTL/ROSMAP_snRNAseq_Fujita_2024NG/besd/celltype/celltype-eqtl-sumstats.Oli	FALSE
eQTL_ROSMAP_snRNA_celltype_OPC	/storage/yangjianLab/sharedata/molecular_QTL/eQTL/ROSMAP_snRNAseq_Fujita_2024NG/besd/celltype/celltype-eqtl-sumstats.OPC	FALSE
eQTL_ROSMAP_snRNA_subtype_Ast.10	/storage/yangjianLab/sharedata/molecular_QTL/eQTL/ROSMAP_snRNAseq_Fujita_2024NG/besd/subtype/subtype-eqtl-sumstats.Ast.10	FALSE
eQTL_ROSMAP_snRNA_subtype_Ast.1	/storage/yangjianLab/sharedata/molecular_QTL/eQTL/ROSMAP_snRNAseq_Fujita_2024NG/besd/subtype/subtype-eqtl-sumstats.Ast.1	FALSE
eQTL_ROSMAP_snRNA_subtype_Ast.2	/storage/yangjianLab/sharedata/molecular_QTL/eQTL/ROSMAP_snRNAseq_Fujita_2024NG/besd/subtype/subtype-eqtl-sumstats.Ast.2	FALSE
eQTL_ROSMAP_snRNA_subtype_Ast.3	/storage/yangjianLab/sharedata/molecular_QTL/eQTL/ROSMAP_snRNAseq_Fujita_2024NG/besd/subtype/subtype-eqtl-sumstats.Ast.3	FALSE
eQTL_ROSMAP_snRNA_subtype_Ast.4	/storage/yangjianLab/sharedata/molecular_QTL/eQTL/ROSMAP_snRNAseq_Fujita_2024NG/besd/subtype/subtype-eqtl-sumstats.Ast.4	FALSE
eQTL_ROSMAP_snRNA_subtype_Ast.5	/storage/yangjianLab/sharedata/molecular_QTL/eQTL/ROSMAP_snRNAseq_Fujita_2024NG/besd/subtype/subtype-eqtl-sumstats.Ast.5	FALSE
eQTL_ROSMAP_snRNA_subtype_Ast.6	/storage/yangjianLab/sharedata/molecular_QTL/eQTL/ROSMAP_snRNAseq_Fujita_2024NG/besd/subtype/subtype-eqtl-sumstats.Ast.6	FALSE
eQTL_ROSMAP_snRNA_subtype_End.2	/storage/yangjianLab/sharedata/molecular_QTL/eQTL/ROSMAP_snRNAseq_Fujita_2024NG/besd/subtype/subtype-eqtl-sumstats.End.2	FALSE
eQTL_ROSMAP_snRNA_subtype_Exc.10	/storage/yangjianLab/sharedata/molecular_QTL/eQTL/ROSMAP_snRNAseq_Fujita_2024NG/besd/subtype/subtype-eqtl-sumstats.Exc.10	FALSE
eQTL_ROSMAP_snRNA_subtype_Exc.11	/storage/yangjianLab/sharedata/molecular_QTL/eQTL/ROSMAP_snRNAseq_Fujita_2024NG/besd/subtype/subtype-eqtl-sumstats.Exc.11	FALSE
eQTL_ROSMAP_snRNA_subtype_Exc.12	/storage/yangjianLab/sharedata/molecular_QTL/eQTL/ROSMAP_snRNAseq_Fujita_2024NG/besd/subtype/subtype-eqtl-sumstats.Exc.12	FALSE
eQTL_ROSMAP_snRNA_subtype_Exc.13	/storage/yangjianLab/sharedata/molecular_QTL/eQTL/ROSMAP_snRNAseq_Fujita_2024NG/besd/subtype/subtype-eqtl-sumstats.Exc.13	FALSE
eQTL_ROSMAP_snRNA_subtype_Exc.14	/storage/yangjianLab/sharedata/molecular_QTL/eQTL/ROSMAP_snRNAseq_Fujita_2024NG/besd/subtype/subtype-eqtl-sumstats.Exc.14	FALSE
eQTL_ROSMAP_snRNA_subtype_Exc.15	/storage/yangjianLab/sharedata/molecular_QTL/eQTL/ROSMAP_snRNAseq_Fujita_2024NG/besd/subtype/subtype-eqtl-sumstats.Exc.15	FALSE
eQTL_ROSMAP_snRNA_subtype_Exc.16	/storage/yangjianLab/sharedata/molecular_QTL/eQTL/ROSMAP_snRNAseq_Fujita_2024NG/besd/subtype/subtype-eqtl-sumstats.Exc.16	FALSE
eQTL_ROSMAP_snRNA_subtype_Exc.1	/storage/yangjianLab/sharedata/molecular_QTL/eQTL/ROSMAP_snRNAseq_Fujita_2024NG/besd/subtype/subtype-eqtl-sumstats.Exc.1	FALSE
eQTL_ROSMAP_snRNA_subtype_Exc.2	/storage/yangjianLab/sharedata/molecular_QTL/eQTL/ROSMAP_snRNAseq_Fujita_2024NG/besd/subtype/subtype-eqtl-sumstats.Exc.2	FALSE
eQTL_ROSMAP_snRNA_subtype_Exc.3	/storage/yangjianLab/sharedata/molecular_QTL/eQTL/ROSMAP_snRNAseq_Fujita_2024NG/besd/subtype/subtype-eqtl-sumstats.Exc.3	FALSE
eQTL_ROSMAP_snRNA_subtype_Exc.4	/storage/yangjianLab/sharedata/molecular_QTL/eQTL/ROSMAP_snRNAseq_Fujita_2024NG/besd/subtype/subtype-eqtl-sumstats.Exc.4	FALSE
eQTL_ROSMAP_snRNA_subtype_Exc.5	/storage/yangjianLab/sharedata/molecular_QTL/eQTL/ROSMAP_snRNAseq_Fujita_2024NG/besd/subtype/subtype-eqtl-sumstats.Exc.5	FALSE
eQTL_ROSMAP_snRNA_subtype_Exc.6	/storage/yangjianLab/sharedata/molecular_QTL/eQTL/ROSMAP_snRNAseq_Fujita_2024NG/besd/subtype/subtype-eqtl-sumstats.Exc.6	FALSE
eQTL_ROSMAP_snRNA_subtype_Exc.7	/storage/yangjianLab/sharedata/molecular_QTL/eQTL/ROSMAP_snRNAseq_Fujita_2024NG/besd/subtype/subtype-eqtl-sumstats.Exc.7	FALSE
eQTL_ROSMAP_snRNA_subtype_Exc.8	/storage/yangjianLab/sharedata/molecular_QTL/eQTL/ROSMAP_snRNAseq_Fujita_2024NG/besd/subtype/subtype-eqtl-sumstats.Exc.8	FALSE
eQTL_ROSMAP_snRNA_subtype_Exc.9	/storage/yangjianLab/sharedata/molecular_QTL/eQTL/ROSMAP_snRNAseq_Fujita_2024NG/besd/subtype/subtype-eqtl-sumstats.Exc.9	FALSE
eQTL_ROSMAP_snRNA_subtype_Fib.3	/storage/yangjianLab/sharedata/molecular_QTL/eQTL/ROSMAP_snRNAseq_Fujita_2024NG/besd/subtype/subtype-eqtl-sumstats.Fib.3	FALSE
eQTL_ROSMAP_snRNA_subtype_Inh.10	/storage/yangjianLab/sharedata/molecular_QTL/eQTL/ROSMAP_snRNAseq_Fujita_2024NG/besd/subtype/subtype-eqtl-sumstats.Inh.10	FALSE
eQTL_ROSMAP_snRNA_subtype_Inh.11	/storage/yangjianLab/sharedata/molecular_QTL/eQTL/ROSMAP_snRNAseq_Fujita_2024NG/besd/subtype/subtype-eqtl-sumstats.Inh.11	FALSE
eQTL_ROSMAP_snRNA_subtype_Inh.12	/storage/yangjianLab/sharedata/molecular_QTL/eQTL/ROSMAP_snRNAseq_Fujita_2024NG/besd/subtype/subtype-eqtl-sumstats.Inh.12	FALSE
eQTL_ROSMAP_snRNA_subtype_Inh.13	/storage/yangjianLab/sharedata/molecular_QTL/eQTL/ROSMAP_snRNAseq_Fujita_2024NG/besd/subtype/subtype-eqtl-sumstats.Inh.13	FALSE
eQTL_ROSMAP_snRNA_subtype_Inh.15	/storage/yangjianLab/sharedata/molecular_QTL/eQTL/ROSMAP_snRNAseq_Fujita_2024NG/besd/subtype/subtype-eqtl-sumstats.Inh.15	FALSE
eQTL_ROSMAP_snRNA_subtype_Inh.16	/storage/yangjianLab/sharedata/molecular_QTL/eQTL/ROSMAP_snRNAseq_Fujita_2024NG/besd/subtype/subtype-eqtl-sumstats.Inh.16	FALSE
eQTL_ROSMAP_snRNA_subtype_Inh.2	/storage/yangjianLab/sharedata/molecular_QTL/eQTL/ROSMAP_snRNAseq_Fujita_2024NG/besd/subtype/subtype-eqtl-sumstats.Inh.2	FALSE
eQTL_ROSMAP_snRNA_subtype_Inh.3	/storage/yangjianLab/sharedata/molecular_QTL/eQTL/ROSMAP_snRNAseq_Fujita_2024NG/besd/subtype/subtype-eqtl-sumstats.Inh.3	FALSE
eQTL_ROSMAP_snRNA_subtype_Inh.4	/storage/yangjianLab/sharedata/molecular_QTL/eQTL/ROSMAP_snRNAseq_Fujita_2024NG/besd/subtype/subtype-eqtl-sumstats.Inh.4	FALSE
eQTL_ROSMAP_snRNA_subtype_Inh.5	/storage/yangjianLab/sharedata/molecular_QTL/eQTL/ROSMAP_snRNAseq_Fujita_2024NG/besd/subtype/subtype-eqtl-sumstats.Inh.5	FALSE
eQTL_ROSMAP_snRNA_subtype_Inh.6	/storage/yangjianLab/sharedata/molecular_QTL/eQTL/ROSMAP_snRNAseq_Fujita_2024NG/besd/subtype/subtype-eqtl-sumstats.Inh.6	FALSE
eQTL_ROSMAP_snRNA_subtype_Inh.7	/storage/yangjianLab/sharedata/molecular_QTL/eQTL/ROSMAP_snRNAseq_Fujita_2024NG/besd/subtype/subtype-eqtl-sumstats.Inh.7	FALSE
eQTL_ROSMAP_snRNA_subtype_Inh.8	/storage/yangjianLab/sharedata/molecular_QTL/eQTL/ROSMAP_snRNAseq_Fujita_2024NG/besd/subtype/subtype-eqtl-sumstats.Inh.8	FALSE
eQTL_ROSMAP_snRNA_subtype_Inh.9	/storage/yangjianLab/sharedata/molecular_QTL/eQTL/ROSMAP_snRNAseq_Fujita_2024NG/besd/subtype/subtype-eqtl-sumstats.Inh.9	FALSE
eQTL_ROSMAP_snRNA_subtype_Mac	/storage/yangjianLab/sharedata/molecular_QTL/eQTL/ROSMAP_snRNAseq_Fujita_2024NG/besd/subtype/subtype-eqtl-sumstats.Mac	FALSE
eQTL_ROSMAP_snRNA_subtype_Mic.10	/storage/yangjianLab/sharedata/molecular_QTL/eQTL/ROSMAP_snRNAseq_Fujita_2024NG/besd/subtype/subtype-eqtl-sumstats.Mic.10	FALSE
eQTL_ROSMAP_snRNA_subtype_Mic.12	/storage/yangjianLab/sharedata/molecular_QTL/eQTL/ROSMAP_snRNAseq_Fujita_2024NG/besd/subtype/subtype-eqtl-sumstats.Mic.12	FALSE
eQTL_ROSMAP_snRNA_subtype_Mic.13	/storage/yangjianLab/sharedata/molecular_QTL/eQTL/ROSMAP_snRNAseq_Fujita_2024NG/besd/subtype/subtype-eqtl-sumstats.Mic.13	FALSE
eQTL_ROSMAP_snRNA_subtype_Mic.2	/storage/yangjianLab/sharedata/molecular_QTL/eQTL/ROSMAP_snRNAseq_Fujita_2024NG/besd/subtype/subtype-eqtl-sumstats.Mic.2	FALSE
eQTL_ROSMAP_snRNA_subtype_Mic.3	/storage/yangjianLab/sharedata/molecular_QTL/eQTL/ROSMAP_snRNAseq_Fujita_2024NG/besd/subtype/subtype-eqtl-sumstats.Mic.3	FALSE
eQTL_ROSMAP_snRNA_subtype_Mic.4	/storage/yangjianLab/sharedata/molecular_QTL/eQTL/ROSMAP_snRNAseq_Fujita_2024NG/besd/subtype/subtype-eqtl-sumstats.Mic.4	FALSE
eQTL_ROSMAP_snRNA_subtype_Mic.5	/storage/yangjianLab/sharedata/molecular_QTL/eQTL/ROSMAP_snRNAseq_Fujita_2024NG/besd/subtype/subtype-eqtl-sumstats.Mic.5	FALSE
eQTL_ROSMAP_snRNA_subtype_Mic.6	/storage/yangjianLab/sharedata/molecular_QTL/eQTL/ROSMAP_snRNAseq_Fujita_2024NG/besd/subtype/subtype-eqtl-sumstats.Mic.6	FALSE
eQTL_ROSMAP_snRNA_subtype_Mic.7	/storage/yangjianLab/sharedata/molecular_QTL/eQTL/ROSMAP_snRNAseq_Fujita_2024NG/besd/subtype/subtype-eqtl-sumstats.Mic.7	FALSE
eQTL_ROSMAP_snRNA_subtype_Mic.8	/storage/yangjianLab/sharedata/molecular_QTL/eQTL/ROSMAP_snRNAseq_Fujita_2024NG/besd/subtype/subtype-eqtl-sumstats.Mic.8	FALSE
eQTL_ROSMAP_snRNA_subtype_Mic.9	/storage/yangjianLab/sharedata/molecular_QTL/eQTL/ROSMAP_snRNAseq_Fujita_2024NG/besd/subtype/subtype-eqtl-sumstats.Mic.9	FALSE
eQTL_ROSMAP_snRNA_subtype_Oli.11	/storage/yangjianLab/sharedata/molecular_QTL/eQTL/ROSMAP_snRNAseq_Fujita_2024NG/besd/subtype/subtype-eqtl-sumstats.Oli.11	FALSE
eQTL_ROSMAP_snRNA_subtype_Oli.1	/storage/yangjianLab/sharedata/molecular_QTL/eQTL/ROSMAP_snRNAseq_Fujita_2024NG/besd/subtype/subtype-eqtl-sumstats.Oli.1	FALSE
eQTL_ROSMAP_snRNA_subtype_Oli.2	/storage/yangjianLab/sharedata/molecular_QTL/eQTL/ROSMAP_snRNAseq_Fujita_2024NG/besd/subtype/subtype-eqtl-sumstats.Oli.2	FALSE
eQTL_ROSMAP_snRNA_subtype_Oli.3	/storage/yangjianLab/sharedata/molecular_QTL/eQTL/ROSMAP_snRNAseq_Fujita_2024NG/besd/subtype/subtype-eqtl-sumstats.Oli.3	FALSE
eQTL_ROSMAP_snRNA_subtype_Oli.4	/storage/yangjianLab/sharedata/molecular_QTL/eQTL/ROSMAP_snRNAseq_Fujita_2024NG/besd/subtype/subtype-eqtl-sumstats.Oli.4	FALSE
eQTL_ROSMAP_snRNA_subtype_Oli.5	/storage/yangjianLab/sharedata/molecular_QTL/eQTL/ROSMAP_snRNAseq_Fujita_2024NG/besd/subtype/subtype-eqtl-sumstats.Oli.5	FALSE
eQTL_ROSMAP_snRNA_subtype_Oli.6	/storage/yangjianLab/sharedata/molecular_QTL/eQTL/ROSMAP_snRNAseq_Fujita_2024NG/besd/subtype/subtype-eqtl-sumstats.Oli.6	FALSE
eQTL_ROSMAP_snRNA_subtype_Oli.7	/storage/yangjianLab/sharedata/molecular_QTL/eQTL/ROSMAP_snRNAseq_Fujita_2024NG/besd/subtype/subtype-eqtl-sumstats.Oli.7	FALSE
eQTL_ROSMAP_snRNA_subtype_Oli.9	/storage/yangjianLab/sharedata/molecular_QTL/eQTL/ROSMAP_snRNAseq_Fujita_2024NG/besd/subtype/subtype-eqtl-sumstats.Oli.9	FALSE
eQTL_ROSMAP_snRNA_subtype_OPC.1	/storage/yangjianLab/sharedata/molecular_QTL/eQTL/ROSMAP_snRNAseq_Fujita_2024NG/besd/subtype/subtype-eqtl-sumstats.OPC.1	FALSE
eQTL_ROSMAP_snRNA_subtype_OPC.2	/storage/yangjianLab/sharedata/molecular_QTL/eQTL/ROSMAP_snRNAseq_Fujita_2024NG/besd/subtype/subtype-eqtl-sumstats.OPC.2	FALSE
eQTL_ROSMAP_snRNA_subtype_OPC.3	/storage/yangjianLab/sharedata/molecular_QTL/eQTL/ROSMAP_snRNAseq_Fujita_2024NG/besd/subtype/subtype-eqtl-sumstats.OPC.3	FALSE
eQTL_ROSMAP_snRNA_subtype_Peri.2	/storage/yangjianLab/sharedata/molecular_QTL/eQTL/ROSMAP_snRNAseq_Fujita_2024NG/besd/subtype/subtype-eqtl-sumstats.Peri.2	FALSE
sQTL_Microglia	/storage/yangjianLab/sharedata/molecular_QTL/eQTL/microglia_QTL/microglia_meta_eQTL_and_sQTL/GRCh38_version/SMR_besd_format/out_mfg_stg_svz_tha_sClusters.metasoft_besd_format	FALSE
sQTL_BrainMeta	/storage/yangjianLab/sharedata/molecular_QTL/eQTL/BrainMeta_cis_sqtl_summary/GRCh38/BrainMeta_cis_sQTL_chr	TRUE
sQTL_GTEx_Adipose_Subcutaneous	/storage/yangjianLab/sharedata/molecular_QTL/eQTL/gtex_resources_besd/sQTL_hg38/sQTL_besd_hg38/Adipose_Subcutaneous_sQTL_all_chr	TRUE
sQTL_GTEx_Adipose_Visceral_Omentum	/storage/yangjianLab/sharedata/molecular_QTL/eQTL/gtex_resources_besd/sQTL_hg38/sQTL_besd_hg38/Adipose_Visceral_Omentum_sQTL_all_chr	TRUE
sQTL_GTEx_Adrenal_Gland	/storage/yangjianLab/sharedata/molecular_QTL/eQTL/gtex_resources_besd/sQTL_hg38/sQTL_besd_hg38/Adrenal_Gland_sQTL_all_chr	TRUE
sQTL_GTEx_Artery_Aorta	/storage/yangjianLab/sharedata/molecular_QTL/eQTL/gtex_resources_besd/sQTL_hg38/sQTL_besd_hg38/Artery_Aorta_sQTL_all_chr	TRUE
sQTL_GTEx_Artery_Coronary	/storage/yangjianLab/sharedata/molecular_QTL/eQTL/gtex_resources_besd/sQTL_hg38/sQTL_besd_hg38/Artery_Coronary_sQTL_all_chr	TRUE
sQTL_GTEx_Artery_Tibial	/storage/yangjianLab/sharedata/molecular_QTL/eQTL/gtex_resources_besd/sQTL_hg38/sQTL_besd_hg38/Artery_Tibial_sQTL_all_chr	TRUE
sQTL_GTEx_Brain_Amygdala	/storage/yangjianLab/sharedata/molecular_QTL/eQTL/gtex_resources_besd/sQTL_hg38/sQTL_besd_hg38/Brain_Amygdala_sQTL_all_chr	TRUE
sQTL_GTEx_Brain_Anterior_cingulate_cortex_BA24	/storage/yangjianLab/sharedata/molecular_QTL/eQTL/gtex_resources_besd/sQTL_hg38/sQTL_besd_hg38/Brain_Anterior_cingulate_cortex_BA24_sQTL_all_chr	TRUE
sQTL_GTEx_Brain_Caudate_basal_ganglia	/storage/yangjianLab/sharedata/molecular_QTL/eQTL/gtex_resources_besd/sQTL_hg38/sQTL_besd_hg38/Brain_Caudate_basal_ganglia_sQTL_all_chr	TRUE
sQTL_GTEx_Brain_Cerebellar_Hemisphere	/storage/yangjianLab/sharedata/molecular_QTL/eQTL/gtex_resources_besd/sQTL_hg38/sQTL_besd_hg38/Brain_Cerebellar_Hemisphere_sQTL_all_chr	TRUE
sQTL_GTEx_Brain_Cerebellum	/storage/yangjianLab/sharedata/molecular_QTL/eQTL/gtex_resources_besd/sQTL_hg38/sQTL_besd_hg38/Brain_Cerebellum_sQTL_all_chr	TRUE
sQTL_GTEx_Brain_Cortex	/storage/yangjianLab/sharedata/molecular_QTL/eQTL/gtex_resources_besd/sQTL_hg38/sQTL_besd_hg38/Brain_Cortex_sQTL_all_chr	TRUE
sQTL_GTEx_Brain_Frontal_Cortex_BA9	/storage/yangjianLab/sharedata/molecular_QTL/eQTL/gtex_resources_besd/sQTL_hg38/sQTL_besd_hg38/Brain_Frontal_Cortex_BA9_sQTL_all_chr	TRUE
sQTL_GTEx_Brain_Hippocampus	/storage/yangjianLab/sharedata/molecular_QTL/eQTL/gtex_resources_besd/sQTL_hg38/sQTL_besd_hg38/Brain_Hippocampus_sQTL_all_chr	TRUE
sQTL_GTEx_Brain_Hypothalamus	/storage/yangjianLab/sharedata/molecular_QTL/eQTL/gtex_resources_besd/sQTL_hg38/sQTL_besd_hg38/Brain_Hypothalamus_sQTL_all_chr	TRUE
sQTL_GTEx_Brain_Nucleus_accumbens_basal_ganglia	/storage/yangjianLab/sharedata/molecular_QTL/eQTL/gtex_resources_besd/sQTL_hg38/sQTL_besd_hg38/Brain_Nucleus_accumbens_basal_ganglia_sQTL_all_chr	TRUE
sQTL_GTEx_Brain_Putamen_basal_ganglia	/storage/yangjianLab/sharedata/molecular_QTL/eQTL/gtex_resources_besd/sQTL_hg38/sQTL_besd_hg38/Brain_Putamen_basal_ganglia_sQTL_all_chr	TRUE
sQTL_GTEx_Brain_Spinal_cord_cervical_c-1	/storage/yangjianLab/sharedata/molecular_QTL/eQTL/gtex_resources_besd/sQTL_hg38/sQTL_besd_hg38/Brain_Spinal_cord_cervical_c-1_sQTL_all_chr	TRUE
sQTL_GTEx_Brain_Substantia_nigra	/storage/yangjianLab/sharedata/molecular_QTL/eQTL/gtex_resources_besd/sQTL_hg38/sQTL_besd_hg38/Brain_Substantia_nigra_sQTL_all_chr	TRUE
sQTL_GTEx_Breast_Mammary_Tissue	/storage/yangjianLab/sharedata/molecular_QTL/eQTL/gtex_resources_besd/sQTL_hg38/sQTL_besd_hg38/Breast_Mammary_Tissue_sQTL_all_chr	TRUE
sQTL_GTEx_Cells_Cultured_fibroblasts	/storage/yangjianLab/sharedata/molecular_QTL/eQTL/gtex_resources_besd/sQTL_hg38/sQTL_besd_hg38/Cells_Cultured_fibroblasts_sQTL_all_chr	TRUE
sQTL_GTEx_Cells_EBV-transformed_lymphocytes	/storage/yangjianLab/sharedata/molecular_QTL/eQTL/gtex_resources_besd/sQTL_hg38/sQTL_besd_hg38/Cells_EBV-transformed_lymphocytes_sQTL_all_chr	TRUE
sQTL_GTEx_Colon_Sigmoid	/storage/yangjianLab/sharedata/molecular_QTL/eQTL/gtex_resources_besd/sQTL_hg38/sQTL_besd_hg38/Colon_Sigmoid_sQTL_all_chr	TRUE
sQTL_GTEx_Colon_Transverse	/storage/yangjianLab/sharedata/molecular_QTL/eQTL/gtex_resources_besd/sQTL_hg38/sQTL_besd_hg38/Colon_Transverse_sQTL_all_chr	TRUE
sQTL_GTEx_Esophagus_Gastroesophageal_Junction	/storage/yangjianLab/sharedata/molecular_QTL/eQTL/gtex_resources_besd/sQTL_hg38/sQTL_besd_hg38/Esophagus_Gastroesophageal_Junction_sQTL_all_chr	TRUE
sQTL_GTEx_Esophagus_Mucosa	/storage/yangjianLab/sharedata/molecular_QTL/eQTL/gtex_resources_besd/sQTL_hg38/sQTL_besd_hg38/Esophagus_Mucosa_sQTL_all_chr	TRUE
sQTL_GTEx_Esophagus_Muscularis	/storage/yangjianLab/sharedata/molecular_QTL/eQTL/gtex_resources_besd/sQTL_hg38/sQTL_besd_hg38/Esophagus_Muscularis_sQTL_all_chr	TRUE
sQTL_GTEx_Heart_Atrial_Appendage	/storage/yangjianLab/sharedata/molecular_QTL/eQTL/gtex_resources_besd/sQTL_hg38/sQTL_besd_hg38/Heart_Atrial_Appendage_sQTL_all_chr	TRUE
sQTL_GTEx_Heart_Left_Ventricle	/storage/yangjianLab/sharedata/molecular_QTL/eQTL/gtex_resources_besd/sQTL_hg38/sQTL_besd_hg38/Heart_Left_Ventricle_sQTL_all_chr	TRUE
sQTL_GTEx_Kidney_Cortex	/storage/yangjianLab/sharedata/molecular_QTL/eQTL/gtex_resources_besd/sQTL_hg38/sQTL_besd_hg38/Kidney_Cortex_sQTL_all_chr	TRUE
sQTL_GTEx_Liver	/storage/yangjianLab/sharedata/molecular_QTL/eQTL/gtex_resources_besd/sQTL_hg38/sQTL_besd_hg38/Liver_sQTL_all_chr	TRUE
sQTL_GTEx_Lung	/storage/yangjianLab/sharedata/molecular_QTL/eQTL/gtex_resources_besd/sQTL_hg38/sQTL_besd_hg38/Lung_sQTL_all_chr	TRUE
sQTL_GTEx_Minor_Salivary_Gland	/storage/yangjianLab/sharedata/molecular_QTL/eQTL/gtex_resources_besd/sQTL_hg38/sQTL_besd_hg38/Minor_Salivary_Gland_sQTL_all_chr	TRUE
sQTL_GTEx_Muscle_Skeletal	/storage/yangjianLab/sharedata/molecular_QTL/eQTL/gtex_resources_besd/sQTL_hg38/sQTL_besd_hg38/Muscle_Skeletal_sQTL_all_chr	TRUE
sQTL_GTEx_Nerve_Tibial	/storage/yangjianLab/sharedata/molecular_QTL/eQTL/gtex_resources_besd/sQTL_hg38/sQTL_besd_hg38/Nerve_Tibial_sQTL_all_chr	TRUE
sQTL_GTEx_Ovary	/storage/yangjianLab/sharedata/molecular_QTL/eQTL/gtex_resources_besd/sQTL_hg38/sQTL_besd_hg38/Ovary_sQTL_all_chr	TRUE
sQTL_GTEx_Pancreas	/storage/yangjianLab/sharedata/molecular_QTL/eQTL/gtex_resources_besd/sQTL_hg38/sQTL_besd_hg38/Pancreas_sQTL_all_chr	TRUE
sQTL_GTEx_Pituitary	/storage/yangjianLab/sharedata/molecular_QTL/eQTL/gtex_resources_besd/sQTL_hg38/sQTL_besd_hg38/Pituitary_sQTL_all_chr	TRUE
sQTL_GTEx_Prostate	/storage/yangjianLab/sharedata/molecular_QTL/eQTL/gtex_resources_besd/sQTL_hg38/sQTL_besd_hg38/Prostate_sQTL_all_chr	TRUE
sQTL_GTEx_Skin_Not_Sun_Exposed_Suprapubic	/storage/yangjianLab/sharedata/molecular_QTL/eQTL/gtex_resources_besd/sQTL_hg38/sQTL_besd_hg38/Skin_Not_Sun_Exposed_Suprapubic_sQTL_all_chr	TRUE
sQTL_GTEx_Skin_Sun_Exposed_Lower_leg	/storage/yangjianLab/sharedata/molecular_QTL/eQTL/gtex_resources_besd/sQTL_hg38/sQTL_besd_hg38/Skin_Sun_Exposed_Lower_leg_sQTL_all_chr	TRUE
sQTL_GTEx_Small_Intestine_Terminal_Ileum	/storage/yangjianLab/sharedata/molecular_QTL/eQTL/gtex_resources_besd/sQTL_hg38/sQTL_besd_hg38/Small_Intestine_Terminal_Ileum_sQTL_all_chr	TRUE
sQTL_GTEx_Spleen	/storage/yangjianLab/sharedata/molecular_QTL/eQTL/gtex_resources_besd/sQTL_hg38/sQTL_besd_hg38/Spleen_sQTL_all_chr	TRUE
sQTL_GTEx_Stomach	/storage/yangjianLab/sharedata/molecular_QTL/eQTL/gtex_resources_besd/sQTL_hg38/sQTL_besd_hg38/Stomach_sQTL_all_chr	TRUE
sQTL_GTEx_Testis	/storage/yangjianLab/sharedata/molecular_QTL/eQTL/gtex_resources_besd/sQTL_hg38/sQTL_besd_hg38/Testis_sQTL_all_chr	TRUE
sQTL_GTEx_Thyroid	/storage/yangjianLab/sharedata/molecular_QTL/eQTL/gtex_resources_besd/sQTL_hg38/sQTL_besd_hg38/Thyroid_sQTL_all_chr	TRUE
sQTL_GTEx_Uterus	/storage/yangjianLab/sharedata/molecular_QTL/eQTL/gtex_resources_besd/sQTL_hg38/sQTL_besd_hg38/Uterus_sQTL_all_chr	TRUE
sQTL_GTEx_Vagina	/storage/yangjianLab/sharedata/molecular_QTL/eQTL/gtex_resources_besd/sQTL_hg38/sQTL_besd_hg38/Vagina_sQTL_all_chr	TRUE
sQTL_GTEx_Whole_Blood	/storage/yangjianLab/sharedata/molecular_QTL/eQTL/gtex_resources_besd/sQTL_hg38/sQTL_besd_hg38/Whole_Blood_sQTL_all_chr	TRUE
pQTL_3brain	/storage/yangjianLab/sharedata/molecular_QTL/pQTL/freeze1/merged_pQTL_brain/GRCh38/merged_pQTL_brain_38_update	FALSE
pQTL_6plasma	/storage/yangjianLab/sharedata/molecular_QTL/pQTL/freeze1/merged_pQTL_plasma/merged_6pQTL_plasma_GRCh38_chr	TRUE
pQTL_FHS	/storage/yangjianLab/sharedata/molecular_QTL/pQTL/pQTL_FHS/BESD/GRCh38/pqtl-1000G	FALSE
pQTL_FENLAND	/storage/yangjianLab/sharedata/molecular_QTL/pQTL/pQTL_FENLAND/GRCh38/pQTL_FENLAND_merged_all_update	FALSE
pQTL_ARIC	/storage/yangjianLab/sharedata/molecular_QTL/pQTL/pQTL_ARIC/GRCh38_version/SMR_Besd_format/pQTL_ARIC_EA_besd	FALSE
pQTL_AGES	/storage/yangjianLab/sharedata/molecular_QTL/pQTL/pQTL_AGES/GRCh38_version/pQTL_AGES_all_dense_chr	TRUE
pQTL_SCALLOP	/storage/yangjianLab/sharedata/molecular_QTL/pQTL/pQTL_SCALLOP/besd/ninety_pQTL_format_eQTL	FALSE
pQTL_INTERVAL	/storage/yangjianLab/sharedata/molecular_QTL/pQTL/pQTL_INTERVAL/pQTL_3KProt	FALSE
mQTL_GoDMC	/storage/yangjianLab/sharedata/molecular_QTL/mQTL/GoDMC/BESD_GRCh38/assoc_meta_chr	TRUE
mQTL_BrainMeta	/storage/yangjianLab/sharedata/molecular_QTL/mQTL/Brain-mMeta/GRCh38/Brain-mMeta_GRCh38	FALSE
mQTL_McRae	/storage/yangjianLab/sharedata/molecular_QTL/mQTL/LBC_BSGS_meta/GRCh38/bl_mqtl_chr	TRUE
mQTL_GTEx_Breast_Mammary_Tissue	/storage/yangjianLab/sharedata/molecular_QTL/mQTL/GTEx/besd_hg38/BreastMammaryTissue_mQTLs_chr	TRUE
mQTL_GTEx_Kidney_Cortex	/storage/yangjianLab/sharedata/molecular_QTL/mQTL/GTEx/besd_hg38/KidneyCortex_mQTLs_chr	TRUE
mQTL_GTEx_Muscle_Skeletal	/storage/yangjianLab/sharedata/molecular_QTL/mQTL/GTEx/besd_hg38/MuscleSkeletal_mQTLs_chr	TRUE
mQTL_GTEx_Prostate	/storage/yangjianLab/sharedata/molecular_QTL/mQTL/GTEx/besd_hg38/Prostate_mQTLs_chr	TRUE
mQTL_GTEx_Whole_Blood	/storage/yangjianLab/sharedata/molecular_QTL/mQTL/GTEx/besd_hg38/WholeBlood_mQTLs_chr	TRUE
mQTL_GTEx_Colon_Transverse	/storage/yangjianLab/sharedata/molecular_QTL/mQTL/GTEx/besd_hg38/ColonTransverse_mQTLs_chr	TRUE
mQTL_GTEx_Lung	/storage/yangjianLab/sharedata/molecular_QTL/mQTL/GTEx/besd_hg38/Lung_mQTLs_chr	TRUE
mQTL_GTEx_Ovary	/storage/yangjianLab/sharedata/molecular_QTL/mQTL/GTEx/besd_hg38/Ovary_mQTLs_chr	TRUE
mQTL_GTEx_Testis	/storage/yangjianLab/sharedata/molecular_QTL/mQTL/GTEx/besd_hg38/Testis_mQTLs_chr	TRUE
hQTL_H3K9ac_ROSMAP	/storage/yangjianLab/sharedata/molecular_QTL/hQTL/xQTLServe/besd/hg38/ROSMAP_H3K9AC_update_chr	TRUE
hQTL_H3K4me1_BLUEPRINT	/storage/yangjianLab/sharedata/molecular_QTL/hQTL/blueprint/besd/GRCh38/K4ME1_log2rpm_peer_10_all_summary_update	FALSE
hQTL_H3K27ac_BLUEPRINT	/storage/yangjianLab/sharedata/molecular_QTL/hQTL/blueprint/besd/GRCh38/K4ME1_log2rpm_peer_10_all_summary_update	FALSE
hQTL_H3K27ac_GTEx_Heart	/storage/yangjianLab/sharedata/molecular_QTL/hQTL/GTEx/besd/gARE_heart	FALSE
hQTL_H3K27ac_GTEx_Brain	/storage/yangjianLab/sharedata/molecular_QTL/hQTL/GTEx/besd/gARE_brain	FALSE
hQTL_H3K27ac_GTEx_Lung	/storage/yangjianLab/sharedata/molecular_QTL/hQTL/GTEx/besd/gARE_lung	FALSE
hQTL_H3K27ac_GTEx_Muscle	/storage/yangjianLab/sharedata/molecular_QTL/hQTL/GTEx/besd/gARE_muscle	FALSE
caQTL_Brain	/storage/yangjianLab/sharedata/molecular_QTL/caQTL/Bryois_2018_NatComm/GRCh38/bryois_NatCommun_2018_50kb_cQTLs_update	FALSE
caQTL_Blood	/storage/yangjianLab/sharedata/molecular_QTL/caQTL/Kumasaka_2018_NatGenet/GRCh38/caQTL_sparse_update	FALSE
caQTL_Neuro	/storage/yangjianLab/sharedata/molecular_QTL/caQTL/Brain_Neuron_Glia_Zeng_2023_BioRxiv/besd/neuron_meta_caQTL_chr	TRUE
caQTL_Glia	/storage/yangjianLab/sharedata/molecular_QTL/caQTL/Brain_Neuron_Glia_Zeng_2023_BioRxiv/besd/glia_meta_caQTL_chr	TRUE
caQTL_Microglia	/storage/yangjianLab/sharedata/molecular_QTL/caQTL/Microglia_Regulome_Kosoy_2022_NG/besd/microglia_macrophage_meta-caQTL_summary_chr	TRUE