sQTL_microglia	/storage/yangjianLab/sharedata/molecular_QTL/eQTL/microglia_QTL/microglia_meta_eQTL_and_sQTL/GRCh38_version/SMR_besd_format/out_mfg_stg_svz_tha_sClusters.metasoft_besd_format	FALSE
sQTL_BrainMeta	/storage/yangjianLab/sharedata/molecular_QTL/eQTL/BrainMeta_cis_sqtl_summary/GRCh38/BrainMeta_cis_sQTL_chr	TRUE
sQTL_GTEx_Adipose_Subcutaneous	/storage/yangjianLab/sharedata/molecular_QTL/eQTL/gtex_resources_besd/sQTL_hg38/sQTL_besd_hg38/Adipose_Subcutaneous_sQTL_all_chr	TRUE
sQTL_GTEx_Adipose_Visceral_Omentum	/storage/yangjianLab/sharedata/molecular_QTL/eQTL/gtex_resources_besd/sQTL_hg38/sQTL_besd_hg38/Adipose_Visceral_Omentum_sQTL_all_chr	TRUE
sQTL_GTEx_Adrenal_Gland	/storage/yangjianLab/sharedata/molecular_QTL/eQTL/gtex_resources_besd/sQTL_hg38/sQTL_besd_hg38/Adrenal_Gland_sQTL_all_chr	TRUE
sQTL_GTEx_Artery_Aorta	/storage/yangjianLab/sharedata/molecular_QTL/eQTL/gtex_resources_besd/sQTL_hg38/sQTL_besd_hg38/Artery_Aorta_sQTL_all_chr	TRUE
sQTL_GTEx_Artery_Coronary	/storage/yangjianLab/sharedata/molecular_QTL/eQTL/gtex_resources_besd/sQTL_hg38/sQTL_besd_hg38/Artery_Coronary_sQTL_all_chr	TRUE
sQTL_GTEx_Artery_Tibial	/storage/yangjianLab/sharedata/molecular_QTL/eQTL/gtex_resources_besd/sQTL_hg38/sQTL_besd_hg38/Artery_Tibial_sQTL_all_chr	TRUE
sQTL_GTEx_Brain_Amygdala	/storage/yangjianLab/sharedata/molecular_QTL/eQTL/gtex_resources_besd/sQTL_hg38/sQTL_besd_hg38/Brain_Amygdala_sQTL_all_chr	TRUE
sQTL_GTEx_Brain_Anterior_cingulate_cortex_BA24	/storage/yangjianLab/sharedata/molecular_QTL/eQTL/gtex_resources_besd/sQTL_hg38/sQTL_besd_hg38/Brain_Anterior_cingulate_cortex_BA24_sQTL_all_chr	TRUE
sQTL_GTEx_Brain_Caudate_basal_ganglia	/storage/yangjianLab/sharedata/molecular_QTL/eQTL/gtex_resources_besd/sQTL_hg38/sQTL_besd_hg38/Brain_Caudate_basal_ganglia_sQTL_all_chr	TRUE
sQTL_GTEx_Brain_Cerebellar_Hemisphere	/storage/yangjianLab/sharedata/molecular_QTL/eQTL/gtex_resources_besd/sQTL_hg38/sQTL_besd_hg38/Brain_Cerebellar_Hemisphere_sQTL_all_chr	TRUE
sQTL_GTEx_Brain_Cerebellum	/storage/yangjianLab/sharedata/molecular_QTL/eQTL/gtex_resources_besd/sQTL_hg38/sQTL_besd_hg38/Brain_Cerebellum_sQTL_all_chr	TRUE
sQTL_GTEx_Brain_Cortex	/storage/yangjianLab/sharedata/molecular_QTL/eQTL/gtex_resources_besd/sQTL_hg38/sQTL_besd_hg38/Brain_Cortex_sQTL_all_chr	TRUE
sQTL_GTEx_Brain_Frontal_Cortex_BA9	/storage/yangjianLab/sharedata/molecular_QTL/eQTL/gtex_resources_besd/sQTL_hg38/sQTL_besd_hg38/Brain_Frontal_Cortex_BA9_sQTL_all_chr	TRUE
sQTL_GTEx_Brain_Hippocampus	/storage/yangjianLab/sharedata/molecular_QTL/eQTL/gtex_resources_besd/sQTL_hg38/sQTL_besd_hg38/Brain_Hippocampus_sQTL_all_chr	TRUE
sQTL_GTEx_Brain_Hypothalamus	/storage/yangjianLab/sharedata/molecular_QTL/eQTL/gtex_resources_besd/sQTL_hg38/sQTL_besd_hg38/Brain_Hypothalamus_sQTL_all_chr	TRUE
sQTL_GTEx_Brain_Nucleus_accumbens_basal_ganglia	/storage/yangjianLab/sharedata/molecular_QTL/eQTL/gtex_resources_besd/sQTL_hg38/sQTL_besd_hg38/Brain_Nucleus_accumbens_basal_ganglia_sQTL_all_chr	TRUE
sQTL_GTEx_Brain_Putamen_basal_ganglia	/storage/yangjianLab/sharedata/molecular_QTL/eQTL/gtex_resources_besd/sQTL_hg38/sQTL_besd_hg38/Brain_Putamen_basal_ganglia_sQTL_all_chr	TRUE
sQTL_GTEx_Brain_Spinal_cord_cervical_c-1	/storage/yangjianLab/sharedata/molecular_QTL/eQTL/gtex_resources_besd/sQTL_hg38/sQTL_besd_hg38/Brain_Spinal_cord_cervical_c-1_sQTL_all_chr	TRUE
sQTL_GTEx_Brain_Substantia_nigra	/storage/yangjianLab/sharedata/molecular_QTL/eQTL/gtex_resources_besd/sQTL_hg38/sQTL_besd_hg38/Brain_Substantia_nigra_sQTL_all_chr	TRUE
sQTL_GTEx_Breast_Mammary_Tissue	/storage/yangjianLab/sharedata/molecular_QTL/eQTL/gtex_resources_besd/sQTL_hg38/sQTL_besd_hg38/Breast_Mammary_Tissue_sQTL_all_chr	TRUE
sQTL_GTEx_Cells_Cultured_fibroblasts	/storage/yangjianLab/sharedata/molecular_QTL/eQTL/gtex_resources_besd/sQTL_hg38/sQTL_besd_hg38/Cells_Cultured_fibroblasts_sQTL_all_chr	TRUE
sQTL_GTEx_Cells_EBV-transformed_lymphocytes	/storage/yangjianLab/sharedata/molecular_QTL/eQTL/gtex_resources_besd/sQTL_hg38/sQTL_besd_hg38/Cells_EBV-transformed_lymphocytes_sQTL_all_chr	TRUE
sQTL_GTEx_Colon_Sigmoid	/storage/yangjianLab/sharedata/molecular_QTL/eQTL/gtex_resources_besd/sQTL_hg38/sQTL_besd_hg38/Colon_Sigmoid_sQTL_all_chr	TRUE
sQTL_GTEx_Colon_Transverse	/storage/yangjianLab/sharedata/molecular_QTL/eQTL/gtex_resources_besd/sQTL_hg38/sQTL_besd_hg38/Colon_Transverse_sQTL_all_chr	TRUE
sQTL_GTEx_Esophagus_Gastroesophageal_Junction	/storage/yangjianLab/sharedata/molecular_QTL/eQTL/gtex_resources_besd/sQTL_hg38/sQTL_besd_hg38/Esophagus_Gastroesophageal_Junction_sQTL_all_chr	TRUE
sQTL_GTEx_Esophagus_Mucosa	/storage/yangjianLab/sharedata/molecular_QTL/eQTL/gtex_resources_besd/sQTL_hg38/sQTL_besd_hg38/Esophagus_Mucosa_sQTL_all_chr	TRUE
sQTL_GTEx_Esophagus_Muscularis	/storage/yangjianLab/sharedata/molecular_QTL/eQTL/gtex_resources_besd/sQTL_hg38/sQTL_besd_hg38/Esophagus_Muscularis_sQTL_all_chr	TRUE
sQTL_GTEx_Heart_Atrial_Appendage	/storage/yangjianLab/sharedata/molecular_QTL/eQTL/gtex_resources_besd/sQTL_hg38/sQTL_besd_hg38/Heart_Atrial_Appendage_sQTL_all_chr	TRUE
sQTL_GTEx_Heart_Left_Ventricle	/storage/yangjianLab/sharedata/molecular_QTL/eQTL/gtex_resources_besd/sQTL_hg38/sQTL_besd_hg38/Heart_Left_Ventricle_sQTL_all_chr	TRUE
sQTL_GTEx_Kidney_Cortex	/storage/yangjianLab/sharedata/molecular_QTL/eQTL/gtex_resources_besd/sQTL_hg38/sQTL_besd_hg38/Kidney_Cortex_sQTL_all_chr	TRUE
sQTL_GTEx_Liver	/storage/yangjianLab/sharedata/molecular_QTL/eQTL/gtex_resources_besd/sQTL_hg38/sQTL_besd_hg38/Liver_sQTL_all_chr	TRUE
sQTL_GTEx_Lung	/storage/yangjianLab/sharedata/molecular_QTL/eQTL/gtex_resources_besd/sQTL_hg38/sQTL_besd_hg38/Lung_sQTL_all_chr	TRUE
sQTL_GTEx_Minor_Salivary_Gland	/storage/yangjianLab/sharedata/molecular_QTL/eQTL/gtex_resources_besd/sQTL_hg38/sQTL_besd_hg38/Minor_Salivary_Gland_sQTL_all_chr	TRUE
sQTL_GTEx_Muscle_Skeletal	/storage/yangjianLab/sharedata/molecular_QTL/eQTL/gtex_resources_besd/sQTL_hg38/sQTL_besd_hg38/Muscle_Skeletal_sQTL_all_chr	TRUE
sQTL_GTEx_Nerve_Tibial	/storage/yangjianLab/sharedata/molecular_QTL/eQTL/gtex_resources_besd/sQTL_hg38/sQTL_besd_hg38/Nerve_Tibial_sQTL_all_chr	TRUE
sQTL_GTEx_Ovary	/storage/yangjianLab/sharedata/molecular_QTL/eQTL/gtex_resources_besd/sQTL_hg38/sQTL_besd_hg38/Ovary_sQTL_all_chr	TRUE
sQTL_GTEx_Pancreas	/storage/yangjianLab/sharedata/molecular_QTL/eQTL/gtex_resources_besd/sQTL_hg38/sQTL_besd_hg38/Pancreas_sQTL_all_chr	TRUE
sQTL_GTEx_Pituitary	/storage/yangjianLab/sharedata/molecular_QTL/eQTL/gtex_resources_besd/sQTL_hg38/sQTL_besd_hg38/Pituitary_sQTL_all_chr	TRUE
sQTL_GTEx_Prostate	/storage/yangjianLab/sharedata/molecular_QTL/eQTL/gtex_resources_besd/sQTL_hg38/sQTL_besd_hg38/Prostate_sQTL_all_chr	TRUE
sQTL_GTEx_Skin_Not_Sun_Exposed_Suprapubic	/storage/yangjianLab/sharedata/molecular_QTL/eQTL/gtex_resources_besd/sQTL_hg38/sQTL_besd_hg38/Skin_Not_Sun_Exposed_Suprapubic_sQTL_all_chr	TRUE
sQTL_GTEx_Skin_Sun_Exposed_Lower_leg	/storage/yangjianLab/sharedata/molecular_QTL/eQTL/gtex_resources_besd/sQTL_hg38/sQTL_besd_hg38/Skin_Sun_Exposed_Lower_leg_sQTL_all_chr	TRUE
sQTL_GTEx_Small_Intestine_Terminal_Ileum	/storage/yangjianLab/sharedata/molecular_QTL/eQTL/gtex_resources_besd/sQTL_hg38/sQTL_besd_hg38/Small_Intestine_Terminal_Ileum_sQTL_all_chr	TRUE
sQTL_GTEx_Spleen	/storage/yangjianLab/sharedata/molecular_QTL/eQTL/gtex_resources_besd/sQTL_hg38/sQTL_besd_hg38/Spleen_sQTL_all_chr	TRUE
sQTL_GTEx_Stomach	/storage/yangjianLab/sharedata/molecular_QTL/eQTL/gtex_resources_besd/sQTL_hg38/sQTL_besd_hg38/Stomach_sQTL_all_chr	TRUE
sQTL_GTEx_Testis	/storage/yangjianLab/sharedata/molecular_QTL/eQTL/gtex_resources_besd/sQTL_hg38/sQTL_besd_hg38/Testis_sQTL_all_chr	TRUE
sQTL_GTEx_Thyroid	/storage/yangjianLab/sharedata/molecular_QTL/eQTL/gtex_resources_besd/sQTL_hg38/sQTL_besd_hg38/Thyroid_sQTL_all_chr	TRUE
sQTL_GTEx_Uterus	/storage/yangjianLab/sharedata/molecular_QTL/eQTL/gtex_resources_besd/sQTL_hg38/sQTL_besd_hg38/Uterus_sQTL_all_chr	TRUE
sQTL_GTEx_Vagina	/storage/yangjianLab/sharedata/molecular_QTL/eQTL/gtex_resources_besd/sQTL_hg38/sQTL_besd_hg38/Vagina_sQTL_all_chr	TRUE
sQTL_GTEx_Whole_Blood	/storage/yangjianLab/sharedata/molecular_QTL/eQTL/gtex_resources_besd/sQTL_hg38/sQTL_besd_hg38/Whole_Blood_sQTL_all_chr	TRUE
